############
#        O #
#   P   #########
#               #
#######         #
#  O ##         #
#    ##    ######
#          #
#      XX  #
#      #   #
############